====== PHRASES ======

=== Как рассказать о погоде на французском ===

Le temps est beau aujourd`hui. (Сегодня прекрасная погода); \\
La journée est ensoleillée. (Сегодня солнечно.); \\
Il y a du soleil. Le soleil brille. (Солнечно. Солнце светит.); \\
Regardez! Il y a un arc-en-ciel! (Смотрите! Радуга!); \\
Le temps est magnifique! (Прекрасная погода!); \\
Le ciel est clair et bleu. (Небо чистое и голубое.); \\
Il y a un rayon de soleil/une éclaircie (Проясняется.); \\

Aujourd`hui il fait mauvais. (Сегодня плохая погода.); \\
Aujourd`hui il fait du vent. (Сегодня ветрено.); \\
Il pleut. (Идёт дождь.); \\
Le ciel est couvert. (Небо затянуто облаками.); \\
Cela menace. (Вот-вот пойдёт дождь.); \\
Il fait humide. ( Сыро.); \\
Il y a du brouillard/du verglas. (Туманно/Гололёд.); \\
Un orage éclate. (Начинается гроза.); \\
La pluie est forte. (Сильный дождь.); \\
Le vent souffle fort. (Сильно дует ветер.); \\
Les rues sont enneigées. (Улицы засыпало снегом.); \\
Le vent est strident et pénétrant. (Ветер резкий и пронизывающий); \\
Il y a une averse. (Начался ливень.).

Il fait un temps de chien. (Говорят о любой неприятной погоде; дословно «собачья погода».); \\
Il fait un froid de canard. (Холодно, собачий холод; дословно «утиный холод».); \\
Il fait un soleil de plomb. (Палящее солнце; дословно «свинцовое солнце».); \\
C`est une vraie chute de neige. (Настоящий снегопад.); \\
Il tombe des cordes. (Льёт, как из ведра; дословно «с неба падают верёвки».).

Diable bat sa femme et marie sa fille. (Так говорят в том случае, когда идёт дождь и одновременно светит солнце; дословно «дьявол бьёт свою жену и выдаёт замуж дочь».).

Quel temps fait-il aujourd`hui? (Какая сегодня погода?); \\
Quelle est la température aujourd`hui? (Какая сегодня температура?); \\
Quelle est la météo pour demain? (Какой прогноз погоды на завтра?

=== Вводные слова, слова связки и предлоги ===

à cause de - по причине, из-за \\
à force de - в силу \\
attendu que - принимая во внимание \\
alors - тогда, в таком случае ; и поэтому; итак \\
après (quoi) - после (чего) \\
au préalable - предварительно \\
au reste - впрочем; что до остального \\
aussi - также \\
autre aspect de - другая сторона \\
assez … pour que - достаточно, чтобы \\
avant cela - до этого \\
à l’exception de - за исключением \\
bientôt - скоро \\
bref - короче \\
bien que - хотя \\
car - так как \\
c’est que - дело в том,что \\
c’est ainsi que - так, например \\
c’est pourquoi - вот поэтому \\
cependant - однако \\
d’abord - сначала \\
dans un premier temps - сначала, в первое время \\
dès l’instant où - с момента, как \\
de sorte que - так,что…, таким образом, что…, так, чтобы \\
de toute manière - в любом случае \\
de surcroît - сверх того; кроме того \\
d’un autre côté - с другой стороны \\
dans cette optique - с этой точки зрения \\
d’autre part - с другой стороны \\
de même - так же, к тому же \\
de plus - более того \\
donc - итак, поэтому \\
d’une part … d’autre part - с одной стороны, с другой стороны \\
ensuite - затем, потом \\
en premier lieu - в первую очередь \\
en dernier lieu - в последнюю очередь \\
en raison de - принимая во внимание, по причине \\
en conclusion - в заключение \\
en conséquence - соответственно, следовательно \\
en définitive - в конце концов, в конечном счете, в результате \\
en résumé - вкратце, в итоге, в общей сложности \\
en somme - в итоге, в общем; короче говоря \\
en un mot - одним словом \\
enfin - наконец \\
et puis - и потом \\
excepté - за исключением \\
également - также \\
et ce n’est pas tout -и это не всё \\
finalement - в конце концов \\
malgré - несмотря на \\
parce que, puisque - потому что \\
par la suite - впоследствии \\
par le fait que - из-за того, что \\
plus tard - позже \\
plus tôt - раньше \\
pour commencer - чтобы начать \\
pour terminer - чтобы закончить \\
pour cette raison - по этой причине \\
pour toutes ces raisons - по всем этим причинам \\
pour conclure - в заключение \\
tout bien considéré - приняв всё во внимание \\
sous l’effet que - под влиянием \\
voilà pourquoi - вот почему \\

=== Популярные идиомы на французском ===

Jouer avec le feu - Играть с огнем. \\
Tourner autour du pot - Ходить вокруг да около. \\
Il y a à boire et à manger - Тут есть свои за и против. \\
Parler le français comme une vache espagnole - Очень плохо говорить по-французски. \\
c'est une goutte d'eau dans la mer — это капля в море \\
si la mer bouillait, il y aurait bien des poissons de cuits — если бы да кабы, так было б море, не пруды \\
acheter chat en poche — купить кота в мешке  \\
jeter un chat aux jambes de quelqu'un — подложить кому-нибудь свинью  \\
il ne faut pas réveiller le chat qui dort — не буди лиха, пока лихо спит \\ 
à bon chat bon rat — большому кораблю большое плаванье  \\
le chat parti les souris dansent — без кота мышам масленица \\
appeler un chat un chat — называть вещи своими именами  \\
retomber comme un chat sur ses pattes — выйти сухим из воды  \\
écrire comme un chat — писaть, как курица лапой  \\
avoir un chat dans la gorge — охрипнуть  \\
ce n'est pas la mer à boire — это не так уж трудно  \\
C’est là que gît le lièvre - Вот где собака зарыта.  \\
faire un pied de cochon à qn — подложить свинью кому-либо  \\
on n'a pas gardé les cochons ensemble — мы вместе свиней не пасли  \\
manger comme un cochon — есть неопрятно  \\
amis comme cochons — закадычные друзья  \\
avoir une tête de cochon — быть упрям как осёл 
un cochon n'y retrouverait pas ses petits — здесь страшный беспорядок! \\
Se lever du du mauvais pied - Встать в дурном настроении.  \\
Avoir une peur bleue - Душа ушла в пятки. \\
chercher qn par mer et par terre — искать кого-либо повсюду  \\
jeter l'affaire à la mer — бросить дело  \\
qui craint le danger ne doit pas aller en mer — волков бояться - в лес не ходить  \\
il boirait la mer et les poissons — его мучает жажда  \\

=== Как выразить свое мнение — Exprimer son avis / son opinion ===

Je crois que - Я считаю, что \\
Je pense que - Я думаю, что \\
Je trouve que - Я нахожу, что \\
Je considère que - Я считаю / полагаю, что \\
J’estime que - Я полагаю / считаю, что \\
Je suppose que - Я полагаю / считаю, что \\
J’ai l’immpression que - У меня впечатление, что \\
A mon avis - По моему мнению \\
D’après moi - По-моему \\
Pour moi - Для меня \\
Selon moi - По-моему \\
En ce qui me concerne - Что касается меня, \\
Pour ma part - Что касается меня, \\
Personnellement, - Я лично / для меня лично \\
Mon idée, c’est que - Моя идея, это то, что \\
Il me semble que - Мне кажется, что \\




Created on: 2016/01/30 12:23
